"filename", "language", "C++", "C", "Haskell", "comment", "blank", "total"
"/home/darth/EMQX/clickhouse-haskell-1/src/ClickHouseDriver/CBits/varuint.c", "C", 0, 57, 0, 3, 5, 65
"/home/darth/EMQX/clickhouse-haskell-1/src/ClickHouseDriver/Core.hs", "Haskell", 0, 0, 11, 0, 1, 12
"/home/darth/EMQX/clickhouse-haskell-1/src/ClickHouseDriver/Core/Block.hs", "Haskell", 0, 0, 72, 3, 16, 91
"/home/darth/EMQX/clickhouse-haskell-1/src/ClickHouseDriver/Core/Client.hs", "Haskell", 0, 0, 88, 12, 18, 118
"/home/darth/EMQX/clickhouse-haskell-1/src/ClickHouseDriver/Core/ClientProtocol.hs", "Haskell", 0, 0, 23, 7, 19, 49
"/home/darth/EMQX/clickhouse-haskell-1/src/ClickHouseDriver/Core/Column.hs", "Haskell", 0, 0, 259, 52, 23, 334
"/home/darth/EMQX/clickhouse-haskell-1/src/ClickHouseDriver/Core/Connection.hs", "Haskell", 0, 0, 305, 12, 22, 339
"/home/darth/EMQX/clickhouse-haskell-1/src/ClickHouseDriver/Core/Defines.hs", "Haskell", 0, 0, 34, 20, 32, 86
"/home/darth/EMQX/clickhouse-haskell-1/src/ClickHouseDriver/Core/Error.hs", "Haskell", 0, 0, 412, 1, 9, 422
"/home/darth/EMQX/clickhouse-haskell-1/src/ClickHouseDriver/Core/HTTP.hs", "Haskell", 0, 0, 8, 0, 1, 9
"/home/darth/EMQX/clickhouse-haskell-1/src/ClickHouseDriver/Core/HTTP/Client.hs", "Haskell", 0, 0, 183, 21, 27, 231
"/home/darth/EMQX/clickhouse-haskell-1/src/ClickHouseDriver/Core/HTTP/Connection.hs", "Haskell", 0, 0, 29, 3, 9, 41
"/home/darth/EMQX/clickhouse-haskell-1/src/ClickHouseDriver/Core/HTTP/Helpers.hs", "Haskell", 0, 0, 62, 3, 10, 75
"/home/darth/EMQX/clickhouse-haskell-1/src/ClickHouseDriver/Core/HTTP/Types.hs", "Haskell", 0, 0, 18, 0, 5, 23
"/home/darth/EMQX/clickhouse-haskell-1/src/ClickHouseDriver/Core/QueryProcessingStage.hs", "Haskell", 0, 0, 4, 0, 4, 8
"/home/darth/EMQX/clickhouse-haskell-1/src/ClickHouseDriver/Core/ServerProtocol.hs", "Haskell", 0, 0, 37, 14, 16, 67
"/home/darth/EMQX/clickhouse-haskell-1/src/ClickHouseDriver/Core/Types.hs", "Haskell", 0, 0, 215, 9, 22, 246
"/home/darth/EMQX/clickhouse-haskell-1/src/ClickHouseDriver/IO/BufferedReader.hs", "Haskell", 0, 0, 150, 2, 39, 191
"/home/darth/EMQX/clickhouse-haskell-1/src/ClickHouseDriver/IO/BufferedWriter.hs", "Haskell", 0, 0, 82, 6, 21, 109
"/home/darth/EMQX/clickhouse-haskell-1/src/ClickHouseDriver/Include/varuint.h", "C++", 9, 0, 0, 0, 3, 12
"Total", "-", 9, 57, 1992, 168, 302, 2528