"filename", "language", "Haskell", "C", "C++", "comment", "blank", "total"
"/home/darth/EMQX/clickhouse-haskell-1/src/ClickHouseDriver/CBits/varuint.c", "C", 0, 57, 0, 3, 5, 65
"/home/darth/EMQX/clickhouse-haskell-1/src/ClickHouseDriver/Core.hs", "Haskell", 9, 0, 0, 0, 1, 10
"/home/darth/EMQX/clickhouse-haskell-1/src/ClickHouseDriver/Core/Block.hs", "Haskell", 72, 0, 0, 3, 16, 91
"/home/darth/EMQX/clickhouse-haskell-1/src/ClickHouseDriver/Core/Client.hs", "Haskell", 82, 0, 0, 12, 17, 111
"/home/darth/EMQX/clickhouse-haskell-1/src/ClickHouseDriver/Core/ClientProtocol.hs", "Haskell", 23, 0, 0, 7, 19, 49
"/home/darth/EMQX/clickhouse-haskell-1/src/ClickHouseDriver/Core/Column.hs", "Haskell", 254, 0, 0, 52, 33, 339
"/home/darth/EMQX/clickhouse-haskell-1/src/ClickHouseDriver/Core/Connection.hs", "Haskell", 304, 0, 0, 12, 22, 338
"/home/darth/EMQX/clickhouse-haskell-1/src/ClickHouseDriver/Core/Defines.hs", "Haskell", 34, 0, 0, 20, 32, 86
"/home/darth/EMQX/clickhouse-haskell-1/src/ClickHouseDriver/Core/Error.hs", "Haskell", 401, 0, 0, 1, 9, 411
"/home/darth/EMQX/clickhouse-haskell-1/src/ClickHouseDriver/Core/HTTP.hs", "Haskell", 8, 0, 0, 0, 1, 9
"/home/darth/EMQX/clickhouse-haskell-1/src/ClickHouseDriver/Core/HTTP/Client.hs", "Haskell", 183, 0, 0, 21, 27, 231
"/home/darth/EMQX/clickhouse-haskell-1/src/ClickHouseDriver/Core/HTTP/Connection.hs", "Haskell", 29, 0, 0, 3, 9, 41
"/home/darth/EMQX/clickhouse-haskell-1/src/ClickHouseDriver/Core/HTTP/Helpers.hs", "Haskell", 62, 0, 0, 3, 10, 75
"/home/darth/EMQX/clickhouse-haskell-1/src/ClickHouseDriver/Core/HTTP/Types.hs", "Haskell", 18, 0, 0, 1, 5, 24
"/home/darth/EMQX/clickhouse-haskell-1/src/ClickHouseDriver/Core/QueryProcessingStage.hs", "Haskell", 4, 0, 0, 0, 4, 8
"/home/darth/EMQX/clickhouse-haskell-1/src/ClickHouseDriver/Core/ServerProtocol.hs", "Haskell", 37, 0, 0, 14, 16, 67
"/home/darth/EMQX/clickhouse-haskell-1/src/ClickHouseDriver/Core/Types.hs", "Haskell", 217, 0, 0, 7, 24, 248
"/home/darth/EMQX/clickhouse-haskell-1/src/ClickHouseDriver/IO/BufferedReader.hs", "Haskell", 150, 0, 0, 2, 39, 191
"/home/darth/EMQX/clickhouse-haskell-1/src/ClickHouseDriver/IO/BufferedWriter.hs", "Haskell", 82, 0, 0, 6, 21, 109
"/home/darth/EMQX/clickhouse-haskell-1/src/ClickHouseDriver/Include/varuint.h", "C++", 0, 0, 9, 0, 3, 12
"Total", "-", 1969, 57, 9, 167, 313, 2515